$$$//////$////////$////////////
$////////$////////$////////////
$$$//$$//$/$//$$//$$$///$$/$$//
//$/$//$/$$//$//$/$//$/$/$/$/$/
$$$//$$//$/$//$$//$$$//$$$/$/$/